{
    "default": {
        "!": "ɪ",
        "%": "ʊ",
        "0": "ɔ",
        "1": "ʃ",
        "2": "ə",
        "3": "ʒ",
        "4": "ɑ",
        "6": "ð",
        "7": "ʌ",
        "8": "θ",
        "9": "ŋ",
        "^": "ɜ",
        "*": "æ",
        "#": "'",
        ";": ",",
        "ﬁ": "fi",
        "ﬂ": "fl"
    },
    "【外研版】七年级下册英语电子课本": {
        "4": "f",
        "9": "l",
        "Q": "æ",
        "N": "ŋ",
        "Z": "ʒ",
        "T": "θ",
        "D": "ð",
        "S": "ʃ",
        "=": "ɒ",
        "ﬁ": "fi",
        "ﬂ": "fl",
        ";": ""
    },
    "【外研版】七年级上册英语电子课本": {
        "0": "ɔ",
        "1": "ʃ",
        "2": "ə",
        "3": "ʒ",
        "4": "ɑ",
        "6": "ð",
        "7": "ʌ",
        "8": "θ",
        "9": "ŋ",
        "%": "ʊ",
        "!": "ɪ",
        "^": "ɜ",
        "*": "æ",
        "#": "'",
        ";": ","
    },
    "【外研版】八年级上册英语电子课本": {
        "0": "ɔ",
        "1": "ʃ",
        "2": "ə",
        "3": "ʒ",
        "4": "ɑ",
        "6": "ð",
        "7": "ʌ",
        "8": "θ",
        "9": "ŋ",
        "%": "ʊ",
        "!": "ɪ",
        "^": "ɜ",
        "*": "æ",
        "#": "'",
        ";": ","
    }
}